NO ./resources/bookshelf.png
EA ./resources/gemov1.png
SO ./resources/tilledsoil.png
WE ./resources/treerings.png
C 170,200,255
F 130,42,42

                    11111111
        1111111111111000001111111
        1000000000110000000000001
        1011000001110000000000001
        1001E00000000000000000001
111111111011000001110000000000001
100000000011000001110111111111111
11110111111111011100000010001
11110111111111011111010010001
1100000011010101111100000000111111
1000000000000000111100010000000001
1000000000000000110101001000111111
11000001110101011111010000001
11110111 1110101 101111010001
11111111 1111111 111111111111


