NO ./resources/4.xpm
WE ./resources/1.xpm
SO ./resources/2.xpm
EA ./resources/3.xpm
 C 225,30,0
F 0,0,225

        1111111111111111111111111
        1000000000110000000000001
        101100C00111000C000000001
        1001000000000000000000C01
111111111011000001110000000000001
100000000011000001110111111111111
11110111111111011100000010001
11110111111111011111010010001
1100000011010101111100000000111111
10000C00000000001111000100C0000001
10000000C0000000110101001000111111
11000001110101011111010000001
11110111 1110101 101111010N01
11111111 1111111 111111111111